111111111111
1E000000PC01
100000HJ0001
111111111111