111111111111
1E000000PC01
100M00HJ0001
111111111111