11111111
10000001
1PC000E0
11111111