11111111111111111
1PC0000000000000E1
111111111111111111