11111111111
1P0000001E1
1000C011111
11111111111