111111111111111
10000000000C001
1001000000000E1
1P010000C011111
111111111111111