11111111111111111
1PC0000000000000E1
1000000000000000M1
111111111111111111